1280x720
100x620 0 0 0 0
100x360 1 0 0 0
360x620 0 0 0 0
100x100 0 0 0 0
640x360 0 0 0 0
360x100 0 0 0 0
920x100 0 0 0 0
920x620 0 0 0 0
1180x100 0 0 0 0
1180x360 2 0 0 0
1180x620 0 0 0 0